0000000000011111111
0000000000010044441
1111111111110044441
1000010020200044441
1022212002010044441
1002000002010044441
1022012020211111111
100201000001
110111111111
100001000011
100000200011
100221220051
100001000011
11111111111
