001111
111001111
100000201
101001201
104041501
111111111

