111111111111
14400100000111
14400102002001
14400121111001
14400005011001
14400101002011
11111101120201
00102002020201
00100001000001
00111111111111
