000011111
000010001
000012001
0011100211
0010020201
1110101101000111111
1000101101111100441
1020020000000000441
1111101110151100441
0000100000111111111
00001111111
